##########
#b  X   X#
#        #
#   C    #
#        #
#%%%%%%%%#
#  m    C#
#    S O #
#       E#
##########
