##########
#   X   X#
# C      #
####     #
#Xgg     #
####   %%#
# m    %C#
# C    %%#
#b      E#
##########