OOOOOOOOOO
OOOOOOOOOO
##########
#    X X #
#     g# #
#E   C C #
######   #
OOOOO#####
OOOOOOOOOO
OOOOOOOOOO
